SO ./cub3d_m/textures/gold.xpm
NO ./cub3d_m/textures/btc.xpm
WE ./cub3d_m/textures/dasgcoin.xpm
EA ./cub3d_m/textures/brick.xpm

C 0,225,255
F 0,255,128

11111111111111111111111111111111111111
111111111111111111E00011111111111111
111111101111111111101111111111110111
111111101111111111101111111111111111
111111101111111111101111111111111111
1111111011111111111011111111111111111111111111111111
100000000011000000000011000000000001100000110000011
110000000001100000100001000001000000100000000000011
101100000111000000000001100000110000110000110000011
101100000111000000000001100000110000110000110000011
101100000111000000000001000000100001000000100001111
101100000111000000000000000000100001000000100001111
101100000111000000000001100000110000110000110000011
101100000111000000000000000000100001000000100001111
101100000100000000000001000000100001000000100001111
101100000101000000000001100000110000000000100000011
101100000100000000000000000000110000110000110000011
100100000000000000000001111111111111111111111111111
111111111011000001110000010000011111111111111111111
101100000101000000000001100000000000000000100000000111
1011000001000000000000000000001100001100000000000011
100100000000000000000001111111111111111111111111111
111111111011000001110000010000011111111111111111111
101100000101000000000001100000110000000000100000011
101100000100000000000000000000110000110000110000011
100100000000000000000001111111111111111111111111111
111111111011000001110000010000011111111111111111111
101100000101000000000001100000110000000000100000011
101100000100000000000000000000110000110000110000011
100100000000000000000001111111111111111111111111111
111111111011000001110000010000011111111111111111111
101100000101000000000001100000110000000000100000011
101100000100000000000000000000110000110000110000011
100100000000000000000001111111111111111111111111111
111111111011000001110000010000011111111111111111111
101100000101000000000001100000110000000000100000011
101100000100000000000000000000110000110000110000011
100100000000000000000001111111111111111111111111111
111111111011000001110000010000011111111111111111111
101100000101000000000001100000110000000000100000011
101100000100000000000000000000110000110000110000011
100100000000000000000001111111111111111111111111111
111111111011000001110000010000011111111111111111111
101100000101000000000001100000000000000000100000011
101100000100000000000000000000110000110000110000011
100100000000000000000001111111111111111111111111111
111111111011000001110000010000011111111111111111111
111111111100001111111111111111111111111111111111
111111111101001111111111111111111111111111111111
111111111100001111111111111111111111111111111111
111111111101001111111111111111111111111111111111
111111111100001111111111111111111111111111111111
111111111101001111111111111111111111111111111111
111111111101001111111111111111111111111111111111
111111111100001111111111111111111111111111111111
111111111101001111111111111111111111111111111111
1111111111100000111111111111111111111111111111111
111111111111111111111111111111111111111111111111111
